111111111111111111111111111111
1E0000000001C000000000000000C1
111111100001000010000001111111
111111100001000010000000000001
1C00000000000000100000000000P1
111111111111111111111111111111